Wgrave = W + gravecomb @ top
wgrave = w + gravecomb @ top
Wacute = W + acutecomb @ top
wacute = w + acutecomb @ top
Wdieresis = W + dieresiscomb @ top
wdieresis = w + dieresiscomb @ top
Adotbelow = A + dotbelowcmb @ bottom
adotbelow = a + dotbelowcmb @ bottom
Ahoi = A + hookabovecmb @ top
ahoi = a + hookabovecmb @ top
Acircumflexdotbelow = A + circumflexcomb @ A:top + dotbelowcmb @ A:bottom
acircumflexdotbelow = a + circumflexcomb @ a:top + dotbelowcmb @ a:bottom
Abrevedotbelow = A + brevecomb @ A:top + dotbelowcmb @ A:bottom
abrevedotbelow = a + brevecomb @ a:top + dotbelowcmb @ a:bottom
Edotbelow = E + dotbelowcmb @ bottom
edotbelow = e + dotbelowcmb @ bottom
Ehoi = E + hookabovecmb @ top
ehoi = e + hookabovecmb @ top
Etilde = E + tildecomb @ top
etilde = e + tildecomb @ top
Ecircumflexdotbelow = E + circumflexcomb @ E:top + dotbelowcmb @ E:bottom
ecircumflexdotbelow = e + circumflexcomb @ e:top + dotbelowcmb @ e:bottom
Ihoi = I + hookabovecmb @ top
ihoi = idotless + hookabovecmb @ top
Idotbelow = I + dotbelowcmb @ bottom
idotbelow = idotless + dotaccentcmb @ idotless:top + dotbelowcmb @ idotless:bottom
Odotbelow = O + dotbelowcmb @ bottom
odotbelow = o + dotbelowcmb @ bottom
Ohoi = O + hookabovecmb @ top
ohoi = o + hookabovecmb @ top
Ocircumflexdotbelow = O + circumflexcomb @ O:top + dotbelowcmb @ O:bottom
ocircumflexdotbelow = o + circumflexcomb @ o:top + dotbelowcmb @ o:bottom
Ohornacute = Ohorn + acutecomb @ top
ohornacute = ohorn + acutecomb @ top
Ohorngrave = Ohorn + gravecomb @ top
ohorngrave = ohorn + gravecomb @ top
Ohornhoi = Ohorn + hookabovecmb @ top
ohornhoi = ohorn + hookabovecmb @ top
Ohorntilde = Ohorn + tildecomb @ top
ohorntilde = ohorn + tildecomb @ top
Ohorndotbelow = Ohorn + dotbelow @ top
ohorndotbelow = ohorn + dotbelow @ top
Udotbelow = U + dotbelowcmb @ bottom
udotbelow = u + dotbelowcmb @ bottom
Uhoi = U + hookabovecmb @ top
uhoi = u + hookabovecmb @ top
Uhornacute = Uhorn + acutecomb @ top
uhornacute = uhorn + acutecomb @ top
Uhorngrave = Uhorn + gravecomb @ top
uhorngrave = uhorn + gravecomb @ top
Uhornhoi = Uhorn + hookabovecmb @ top
uhornhoi = uhorn + hookabovecmb @ top
Uhorntilde = Uhorn + tildecomb @ top
uhorntilde = uhorn + tildecomb @ top
Uhorndotbelow = Uhorn + dotbelow @ top
uhorndotbelow = uhorn + dotbelow @ top
Ygrave = Y + gravecomb @ top
ygrave = y + gravecomb @ top
Ydotbelow = Y + dotbelowcmb @ bottom
ydotbelow = y + dotbelowcmb @ bottom
Yhoi = Y + hookabovecmb @ top
yhoi = y + hookabovecmb @ top
Ytilde = Y + tildecomb @ top
ytilde = y + tildecomb @ top